1 0 3 0 5 0 6 0 0
6 5 0 1 0 0 0 3 0
0 7 8 0 3 0 0 2 0
0 0 0 0 0 0 8 1 0
0 9 4 0 6 0 7 5 0
0 6 2 0 0 0 0 0 0
0 8 0 0 7 0 4 9 0
0 2 0 0 0 8 0 7 3
0 0 6 0 9 0 5 0 2
